1 1 1 1 1 1 1 1 1 1 1 1 1 1 1 1 1 1 1 1 1 1 1 1
1 6 0 0 0 0 0 0 1 0 0 0 0 0 0 1 0 0 0 0 0 0 6 1
1 0 1 0 1 1 1 0 1 0 1 1 1 1 0 1 0 1 1 1 0 1 0 1
1 0 1 0 1 0 0 0 1 0 1 1 1 1 0 1 0 0 0 1 0 1 0 1
1 0 1 0 1 0 1 0 0 0 0 0 0 0 0 0 0 1 0 1 0 1 0 1
1 0 0 0 1 0 1 0 1 1 0 1 1 0 1 1 0 1 0 1 0 0 0 1
1 0 1 0 0 0 1 0 1 1 0 1 1 0 1 1 0 1 0 0 0 1 0 1
1 0 1 1 1 0 1 0 1 1 0 1 1 0 1 1 0 1 0 1 1 1 0 1
1 0 1 1 1 0 0 0 1 1 0 1 1 0 1 1 0 0 0 1 1 1 0 1
1 0 0 0 0 0 1 5 5 5 5 5 5 5 5 5 5 1 0 0 0 0 0 1
1 0 1 1 1 0 1 1 5 2 2 3 3 2 2 5 1 1 0 1 1 1 0 1
1 0 1 1 1 0 1 1 5 2 5 5 5 5 2 5 1 1 0 1 1 1 0 1
1 0 1 1 1 0 1 1 5 2 2 2 2 2 2 5 1 1 0 1 1 1 0 1
1 0 0 0 0 0 1 5 5 5 5 5 5 5 5 5 5 1 0 0 0 0 0 1
1 0 1 1 1 0 1 0 1 1 0 1 1 0 1 1 0 1 0 1 1 1 0 1
1 0 0 0 0 0 0 0 1 1 0 1 1 0 1 1 0 0 0 0 0 0 0 1
1 0 1 0 1 0 1 0 1 1 0 1 1 0 1 1 0 1 0 1 0 1 0 1
1 0 1 0 0 0 1 0 1 1 0 1 1 0 1 1 0 1 0 0 0 1 0 1
1 0 1 0 1 0 1 0 1 1 0 1 1 0 1 1 0 1 0 1 0 1 0 1
1 0 1 0 1 0 1 0 0 0 0 0 0 0 0 0 0 1 0 1 0 1 0 1
1 0 1 0 1 0 0 0 1 0 1 1 1 1 0 1 0 0 0 1 0 1 0 1
1 0 1 0 1 1 1 0 1 0 1 1 1 1 0 1 0 1 1 1 0 1 0 1
1 6 0 0 0 0 0 0 1 0 0 0 0 0 0 1 0 0 0 0 0 0 6 1
1 1 1 1 1 1 1 1 1 1 1 1 1 1 1 1 1 1 1 1 1 1 1 1